########
#   T  #
#  BB  #
#  P T #
#      #
########
