########
#      #
#  T   #
#  B   #
#  P   #
#      #
########
